..B..B..
.GGGGGG.
..GGGG..
ZZZZZZZZ
.ZZZZZZ.