.ZZZZZZ.
ZZZZZZZZ
..GGGG..
.GGGGGG.
..B..B..